20,22,Highway,101
1,2,3,3,5,2,3,3,5,2,3,3,5,3,3,5,3,3,5,3,3,5
1,2,3,3,5,2,3,3,5,2,3,3,5,3,3,5,3,3,5,3,3,5
1,2,3,3,5,2,3,3,5,2,3,3,5,3,3,5,3,3,5,3,3,5
1,2,3,3,5,2,3,3,5,2,3,3,5,3,3,5,3,3,5,3,3,5
1,2,3,3,5,2,3,3,5,2,3,3,5,3,3,5,3,3,5,3,3,5
1,2,3,3,5,2,3,3,5,2,3,3,5,3,3,5,3,3,5,3,3,5
1,2,2,2,5,2,2,2,5,2,2,2,5,2,2,5,2,2,5,2,2,5
1,2,2,2,5,2,2,2,5,2,2,2,5,2,2,5,2,2,5,2,2,5
1,2,2,2,5,2,2,2,5,2,2,2,5,2,2,5,2,2,5,2,2,5
1,1,3,2,5,1,3,2,5,1,3,2,5,3,2,5,3,2,5,3,2,5
1,1,3,2,5,1,3,2,5,1,3,2,5,3,2,5,3,2,5,3,2,5
1,1,3,2,5,1,3,2,5,1,3,2,5,3,2,5,3,2,5,3,2,5
1,1,3,2,5,1,3,2,5,1,3,2,5,3,2,5,3,2,5,3,2,5
4,1,3,3,5,1,3,3,5,1,3,3,5,3,3,5,3,3,5,3,3,5
4,1,3,3,5,1,3,3,5,1,3,3,5,3,3,5,3,3,5,3,3,5
4,5,3,3,5,5,3,3,5,5,3,3,5,3,3,5,3,3,5,3,3,5
4,5,5,5,5,5,5,5,5,5,5,5,5,5,5,5,5,5,5,5,5,5
4,4,4,4,4,4,4,4,4,4,4,4,4,4,4,4,4,4,4,4,4,4
4,4,4,4,4,4,4,4,4,4,4,4,4,4,4,4,4,4,4,4,4,4
4,4,4,4,4,4,4,4,4,4,4,4,4,4,4,4,4,4,4,4,4,4