60,33,Highway 101
3,3,3,1,1,5,5,5,5,5,1,1,3,3,3,1,1,1,1,1,2,2,2,2,2,1,1,1,4,4,4,4,0
3,3,3,1,1,5,5,5,5,5,1,1,3,3,3,1,1,1,1,1,2,2,2,2,2,1,1,1,4,4,4,4,0
3,3,3,1,1,5,5,5,5,5,1,1,3,3,3,1,1,1,1,1,2,2,2,2,2,1,1,1,4,4,4,4,0
3,3,3,1,1,5,5,5,5,5,1,1,3,3,3,1,1,1,1,1,2,2,2,2,2,1,1,1,4,4,4,4,0
3,3,3,1,1,5,5,5,5,5,1,1,3,3,3,1,1,1,1,1,2,2,2,2,2,1,1,1,4,4,4,4,0
3,3,3,1,1,5,5,5,5,5,1,1,3,3,3,1,1,1,1,1,2,2,2,2,2,1,1,1,4,4,4,4,0
3,3,3,1,1,5,5,5,5,5,1,1,3,3,3,1,1,1,1,1,2,2,2,2,2,1,1,1,4,4,4,4,0
3,3,3,1,1,5,5,5,5,5,1,1,3,3,3,1,1,1,1,1,2,2,2,2,2,1,1,1,4,4,4,4,0
3,3,3,1,1,5,5,5,5,5,1,1,3,3,3,1,1,1,1,1,2,2,2,2,2,1,1,1,4,4,4,4,0
3,3,3,1,1,5,5,5,5,5,1,1,3,3,3,1,1,1,1,1,2,2,2,2,2,1,1,1,4,4,4,4,0
3,3,3,1,1,5,5,5,5,5,1,1,3,3,3,1,1,1,1,1,2,2,2,2,2,1,1,1,4,4,4,4,0
3,3,3,1,1,5,5,5,5,5,1,1,3,3,3,1,1,1,1,1,2,2,2,2,2,1,1,1,4,4,4,4,0
3,3,4,4,4,4,5,5,5,5,1,1,3,3,3,1,1,1,1,1,2,2,2,2,2,1,1,1,4,4,4,4,0
3,3,4,4,4,4,5,5,5,5,1,1,3,3,3,1,1,1,1,1,2,2,2,2,2,1,1,1,4,4,4,4,0
3,3,3,4,4,4,5,5,5,5,1,1,3,3,3,1,1,1,1,1,2,2,2,2,2,1,1,1,4,4,4,4,0
3,3,3,1,1,5,5,5,5,5,1,1,3,3,3,1,1,1,1,1,2,2,2,2,2,1,1,1,4,4,4,4,0
3,3,3,1,1,5,5,5,5,5,1,1,3,3,3,1,1,1,1,1,2,2,2,2,2,1,1,1,4,4,4,4,0
3,3,3,1,1,5,5,5,5,5,1,1,3,3,3,1,1,1,1,1,2,2,2,2,2,1,1,1,4,4,4,4,0
3,3,3,1,1,5,5,5,5,5,1,1,3,3,3,1,1,1,1,1,2,2,2,2,2,1,1,1,4,4,4,4,0
3,3,3,1,1,5,5,5,5,5,1,1,3,3,3,1,1,1,1,1,2,2,2,2,2,1,1,1,4,4,4,4,0
3,3,3,1,1,5,5,5,5,5,1,1,3,3,3,1,1,1,1,1,2,2,2,2,2,1,1,1,4,4,4,4,0
3,3,3,1,1,5,5,5,5,5,1,1,3,3,3,1,1,1,1,1,2,2,2,2,2,1,1,1,4,4,4,4,0
3,3,3,1,1,5,5,5,5,5,1,1,3,3,3,1,1,1,1,1,2,2,2,2,2,1,1,1,4,4,4,4,0
3,3,3,1,1,5,5,5,5,5,1,1,3,3,3,1,1,1,1,1,2,2,2,2,2,1,1,1,4,4,4,4,0
3,3,3,1,1,5,5,5,5,5,1,1,3,3,3,1,1,1,1,1,2,2,2,2,2,1,1,1,4,4,4,4,0
3,3,3,1,1,5,5,5,5,5,1,1,3,3,3,1,1,1,1,1,2,2,2,2,2,1,1,1,4,4,4,4,0
3,3,3,1,1,5,5,5,5,5,1,1,3,3,3,1,1,1,1,1,2,2,2,2,2,1,1,1,4,4,4,4,0
3,3,3,1,1,5,5,5,5,5,1,1,3,3,3,1,1,1,1,1,2,2,2,2,2,1,1,1,4,4,4,4,0
3,3,3,1,1,5,5,5,5,5,1,1,3,3,3,1,1,1,1,1,2,2,2,2,2,1,1,1,4,4,4,4,0
3,3,3,1,1,5,5,5,5,5,1,1,3,3,3,1,1,1,1,1,2,2,2,2,2,1,1,1,4,4,4,4,0
3,3,3,1,1,5,5,5,5,5,1,1,3,3,3,1,1,1,1,1,2,2,2,2,2,1,1,1,4,4,4,4,0
3,3,3,1,1,5,5,5,5,5,1,1,3,3,3,1,1,1,1,1,2,2,2,2,2,1,1,1,4,4,4,4,0
3,3,3,1,1,5,5,5,5,5,1,1,3,3,3,1,1,1,1,1,2,2,2,2,2,1,1,1,4,4,4,4,0
3,3,3,1,1,5,5,5,5,5,1,1,3,3,3,1,1,1,1,1,2,2,2,2,2,1,1,1,4,4,4,4,0
3,3,3,1,1,5,5,5,5,5,1,1,3,3,3,1,1,1,1,1,2,2,2,2,2,1,1,1,4,4,4,4,0
3,3,3,1,1,5,5,5,5,5,1,1,3,3,3,1,1,1,1,1,2,2,2,2,2,1,1,1,4,4,4,4,0
3,3,3,1,1,5,5,5,5,5,1,1,3,3,3,1,1,1,1,1,2,2,2,2,2,1,1,1,4,4,4,4,0
3,3,3,1,1,5,5,5,5,5,1,1,3,3,3,1,1,1,1,1,2,2,2,2,2,1,1,1,4,4,4,4,0
3,3,3,1,1,5,5,5,5,5,1,1,3,3,3,1,1,1,1,1,2,2,2,2,2,1,1,1,4,4,4,4,0
3,3,3,1,1,5,5,5,5,5,1,1,3,3,3,1,1,1,1,1,2,2,2,2,2,1,1,1,4,4,4,4,0
3,3,3,1,1,5,5,5,5,5,1,1,3,3,3,1,1,1,1,1,2,2,2,2,2,1,1,1,4,4,4,4,0
3,3,3,1,1,5,5,5,5,5,1,1,3,3,3,1,1,1,1,1,2,2,2,2,2,1,1,1,4,4,4,4,0
3,3,3,1,1,5,5,5,5,5,1,1,3,3,3,1,1,1,1,1,2,2,2,2,2,1,1,1,4,4,4,4,0
3,3,3,1,1,5,5,5,5,5,1,1,3,3,3,1,1,1,1,1,2,2,2,2,2,1,1,1,4,4,4,4,0
3,3,3,1,1,5,5,5,5,5,1,1,3,3,3,1,1,1,1,1,2,2,2,2,2,1,1,1,4,4,4,4,0
3,3,3,1,1,5,5,5,5,5,1,1,3,3,3,1,1,1,1,1,2,2,2,2,2,1,1,1,4,4,4,4,0
3,3,3,1,1,5,5,5,5,5,1,1,3,3,3,1,1,1,1,1,2,2,2,2,2,1,1,1,4,4,4,4,0
3,3,3,1,1,5,5,5,5,5,1,1,3,3,3,1,1,1,1,1,2,2,2,2,2,1,1,1,4,4,4,4,0
3,3,3,1,1,5,5,5,5,5,1,1,3,3,3,1,1,1,1,1,2,2,2,2,2,1,1,1,4,4,4,4,0
3,3,3,1,1,5,5,5,5,5,1,1,3,3,3,1,1,1,1,1,2,2,2,2,2,1,1,1,4,4,4,4,0
3,3,3,1,1,5,5,5,5,5,1,1,3,3,3,1,1,1,1,1,2,2,2,2,2,1,1,1,4,4,4,4,0
3,3,3,1,1,5,5,5,5,5,1,1,3,3,3,1,1,1,1,1,2,2,2,2,2,1,1,1,4,4,4,4,0
3,3,3,1,1,5,5,5,5,5,1,1,3,3,3,1,1,1,1,1,2,2,2,2,2,1,1,1,4,4,4,4,0
3,3,3,1,1,5,5,5,5,5,1,1,3,3,3,1,1,1,1,1,2,2,2,2,2,1,1,1,4,4,4,4,0
3,3,3,1,1,5,5,5,5,5,1,1,3,3,3,1,1,1,1,1,2,2,2,2,2,1,1,1,4,4,4,4,0
3,3,3,1,1,5,5,5,5,5,1,1,3,3,3,1,1,1,1,1,2,2,2,2,2,1,1,1,4,4,4,4,0
3,3,3,1,1,5,5,5,5,5,1,1,3,3,3,1,1,1,1,1,2,2,2,2,2,1,1,1,4,4,4,4,0
3,3,3,1,1,5,5,5,5,5,1,1,3,3,3,1,1,1,1,1,2,2,2,2,2,1,1,1,4,4,4,4,0
3,3,3,1,1,5,5,5,5,5,1,1,3,3,3,1,1,1,1,1,2,2,2,2,2,1,1,1,4,4,4,4,0
3,3,3,1,1,5,5,5,5,5,1,2,2,2,2,2,1,1,1,4,4,4,4,0,2,1,1,1,4,4,4,4,0