18,10,Highway 101
1,1,1,1,1,1,1,1,1,1
1,1,1,1,1,1,2,2,1,1
1,1,1,1,1,1,2,2,1,1
2,2,2,2,2,2,2,2,1,1
4,4,4,4,4,4,2,2,1,1
1,1,1,1,1,4,3,2,1,1
1,1,1,1,1,1,1,1,1,1
1,1,1,1,1,1,2,2,1,1
1,1,1,1,1,1,2,2,1,1
2,2,2,2,2,2,2,2,1,1
4,4,4,4,4,4,2,2,1,1
1,1,1,1,1,4,3,2,1,1
1,1,1,1,1,1,1,1,1,1
1,1,1,1,1,1,2,2,1,1
1,1,1,1,1,1,2,2,1,1
2,2,2,2,2,2,2,2,1,1
4,4,4,4,4,4,2,2,1,1
1,1,1,1,1,4,3,2,1,1

0,0,0,0,0,1,2,3,4,5
0,0,0,0,0,0,1,1,0,0
1,1,1,1,1,1,1,1,0,0
1,1,1,1,1,1,1,1,0,0
3,3,3,3,3,3,1,1,0,0
0,0,0,0,0,0,0,0,0,0
0,0,0,0,0,0,0,0,0,0
0,0,0,0,0,0,0,0,0,0
0,0,0,0,0,0,0,0,0,0
0,0,0,0,0,0,0,0,0,0
0,0,0,0,0,0,0,0,0,0
0,0,0,0,0,0,0,0,0,0
0,0,0,0,0,0,0,0,0,0
0,0,0,0,0,0,0,0,0,0
0,0,0,0,0,0,0,0,0,0
0,0,0,0,0,0,0,0,0,0
0,0,0,0,0,0,0,0,0,0
0,0,0,0,0,3,2,1,0,0